                  
            
          R 700 450
        
        
        NO ./textures/texture_north.xpm
      SO ./textures/texture_south.xpm
    WE ./textures/texture_west.xpm
  EA ./textures/texture_east.xpm
      S ./textures/sprite.xpm
      
F         48, 53,  64

C 15,   28, 48
      
111111111111111111111111111111
111111111W00200000000000011111
100000000000000000111000100001
110000100000000000000000001111
100001111111000000000001111111
111111100000000000000000000001
111100000000001100000000000011
100000000000000000000000000011
110000000000011110000000000011
100000000000111000000000000011
110000000000111000000000001111
110000000001111000000000000111
111111111111111111111111111111

