                  
            
          R  600       450
        
        
        NO ./textures/texture_north.xpm
      SO ./textures/texture_south.xpm
    WE ./textures/texture_west.xpm
  EA ./textures/texture_east.xpm
      S ./textures/enemy.xpm
      
F         48, 53,  64


C 15,   28, 48

111111111     111111111                     111111 1111111                  
100000001     100000001                    1000001 1000001                  
 100000001     100000001                    1000001 1000001                  
  110222001     100000011                    1000001 100001                  
    1022001     1000001      111111111111     100001  100001    11111111111   
    1002001     1000001    1100000000000011   100001  100001  110000000000011 
    10W0200111110000001   10000001111100000111100001  100001 10000000000000001
    1000200000000000001  10000001     10000000000001  100001 10000011111000001
    1000020000000000001  100000001111100000011100001  100001 100001     100001
    1002000111110000001  1000000000000000001  100001  100001 100001     100001
    1000001     1000001  100000011111111111   100001  100001 100001     100001
    1000001     1000001111100000001           100001  100001 100001     100001
  110000001     1000000000000000001          100000011000000110000011111000001
  100000001     100000001110000000011111111  100000000000000000000000000000001
  100000001     100000001  1100000000000001  10000001100000011110000000000011 
  111111111     111111111    11111111111111  1111111111111111   11111111111