              R 700 500
        NO ./textures/unnamed.xpm
      SO ./textures/wall_south.xpm
    WE ./textures/wall_north.xpm
  EA ./textures/unnamed.xpm
      S ./textures/sprite_test.xpm
F 0,128,0

C 0,103,163

111111111     111111111                     111111 1111111                  
100000001     100000001                    1000001 1000001                  
 100000001     100000001                    1000001 1000001                  
  110000001     100000011                    1000001 100001                  
    1020001     1000001      111111111111     100001  100001    11111111111   
    1000001     1000001    1100000000000011   100001  100001  110000000000011 
    1000000111110000001   10000001111100000111100001  100001 10000000000000001
    10000200000S0000001  10000001     10000000000001  100001 10000011111000001
    1000000000000000001  100000001111100000011100001  100001 100001     100001
    1000000111110000001  1000000000000000001  100001  100001 100001     100001
    1000001     1000001  100000011111111111   100001  100001 100001     100001
    1000001     1000001111100000001           100001  100001 100001     100001
  110000001     1000000000000000001          100000011000000110000011111000001
  100000001     100000001110000000011111111  100000000000000000000000000000001
  100000001     100000001  1100000000000001  10000001100000011110000000000011 
  111111111     111111111    11111111111111  1111111111111111   11111111111